{
    "name": "basic_room",
    "type": "ROOM_BASE",
    "size": {
        "width": 10,
        "height": 8
    },
    "layers": {
        "tiles": [
            [2,2,2,2,2,2,2,2,2,2],
            [2,1,1,1,1,1,1,1,1,2],
            [2,1,1,1,1,1,1,1,1,2],
            [3,1,1,1,1,1,1,1,1,3],
            [2,1,1,1,1,1,1,1,1,2],
            [2,1,1,1,1,1,1,1,1,2],
            [2,1,1,1,1,1,1,1,1,2],
            [2,2,2,2,2,2,2,2,2,2]
        ],
        "objects": [
            [0,0,0,0,0,0,0,0,0,0],
            [0,0,0,0,0,0,0,0,2,0],
            [0,0,0,0,0,0,0,0,0,0],
            [0,0,0,0,0,0,0,0,0,0],
            [0,0,0,0,0,0,0,0,0,0],
            [0,0,0,0,0,0,0,0,0,0],
            [0,2,0,0,0,0,0,0,0,0],
            [0,0,0,0,0,0,0,0,0,0]
        ]
    },
    "spawns": [
        {"type": "npc", "x": 5, "y": 4}
    ],
    "connections": [
        {"side": "west", "y": 3},
        {"side": "east", "y": 3}
    ]
} 